[nivel1]
origen=terrenogen.png
mapa=.........................$
	 .........................$
	 .........$$$.............$
	 .........................$
	 .........................$
	 $$$$$..$$$$$$$$$..$$$$$$$$
	 .........................$
	 .........................$
	 .........$$$$$$$$$.......$
	 .........................$
	 p........................
	 $$$$$$$..................$
	 p........................
	 .........................$
	 .........................$
	 ...............$$$$$$$$$$$
	 .........................$
	 .........................$

[$]
nombre=muro

[p]
nombre=arma